5 5 5 5 5 5 5 5 5 5 5 5 5 5 5 5 5 5 5 5 5 5 5 5 5 5 5 5 5 5 5 5 5 5 5 5 5 5 5 5 5 5
5 5 10 10 10 10 10 10 10 10 10 10 10 10 10 10 5 5 5 5 10 10 10 10 10 1 5 5 5 5 5 5 5 5 5 5 5 5 5 5 5 5
5 5 10 99 99 99 99 99 10 99 99 99 99 99 99 10 5 5 5 5 10 99 99 99 5 1 5 5 5 10 10 10 10 10 10 10 10 10 10 10 5 5
5 5 10 99 99 99 99 99 10 99 99 99 99 99 99 10 10 10 10 10 10 99 99 1 1 1 5 5 5 10 5 5 5 5 5 5 5 5 5 10 5 5
5 5 10 99 99 10 99 99 10 99 99 99 10 99 99 10 99 99 99 99 5 99 99 1 1 1 5 5 5 10 5 5 5 3 3 3 5 5 5 10 5 5
5 5 10 10 10 10 10 10 10 10 10 10 10 10 10 10 10 99 99 99 5 99 99 99 5 1 5 5 5 10 5 5 5 3 3 3 5 5 5 10 5 5
5 5 10 3 3 3 3 3 3 3 3 3 3 3 3 10 10 99 99 99 5 5 5 5 5 1 5 5 5 10 5 5 5 3 3 3 5 5 5 10 5 5
5 5 10 3 3 3 3 3 3 3 3 3 3 3 3 10 99 99 99 99 5 99 99 99 5 1 5 5 5 10 5 5 5 3 3 3 5 5 5 10 5 5
5 5 10 3 3 3 3 5 5 5 5 3 3 3 3 10 10 10 10 10 10 99 99 99 5 1 5 5 5 10 5 5 5 5 5 5 5 5 5 10 5 5
5 5 10 3 3 3 3 5 5 5 5 3 3 3 3 10 5 5 5 5 10 99 99 1 1 1 5 5 5 10 10 10 10 10 10 10 10 10 10 10 5 5
5 5 10 3 3 3 3 5 5 5 5 3 3 3 3 10 5 5 5 5 10 99 99 99 5 1 5 5 5 5 5 5 5 5 10 5 5 5 5 5 5 5
5 5 10 3 3 3 3 3 3 3 3 3 3 3 3 10 5 5 5 5 10 99 99 99 5 1 5 5 5 5 5 5 5 5 10 5 5 5 5 5 5 5
5 5 10 3 3 3 3 3 3 3 3 3 3 3 3 10 5 5 5 5 10 5 5 5 5 1 5 5 5 5 5 5 5 5 10 5 5 5 5 5 5 5
5 5 10 10 10 10 10 10 10 10 10 10 10 10 10 10 1 1 1 1 1 1 1 1 1 1 1 1 1 1 1 1 1 1 1 1 1 1 1 1 1 1
5 5 1 5 5 5 5 5 5 5 5 5 5 5 5 1 5 5 5 5 5 5 5 5 5 1 5 5 5 5 5 5 5 5 5 5 5 5 5 5 5 5
5 5 1 5 99 99 99 5 5 99 99 99 99 5 5 1 5 99 99 99 99 99 99 99 5 1 5 99 99 99 99 99 99 99 5 99 99 99 99 99 5 5
5 5 1 10 10 99 99 5 5 99 99 99 1 1 1 1 5 99 99 99 99 99 99 99 5 1 5 99 99 99 99 99 99 99 5 99 99 99 99 99 5 5
5 5 1 5 99 99 99 5 5 99 99 99 99 5 5 1 5 99 1 99 99 99 1 99 5 1 5 99 99 99 99 1 99 99 5 99 99 1 99 99 5 5
5 5 1 5 5 5 5 5 5 5 5 5 5 5 5 1 5 5 1 5 5 5 1 5 5 1 5 5 5 5 5 1 5 5 5 5 5 1 5 5 5 5
5 5 1 1 1 1 1 1 1 1 1 1 1 1 1 1 1 1 1 1 1 1 1 1 1 1 1 1 1 1 1 1 1 1 1 1 1 1 1 1 5 5
5 5 1 10 10 10 10 10 10 1 5 5 5 5 5 5 5 5 5 5 1 5 5 5 1 5 5 5 5 5 1 5 5 1 5 10 5 5 5 1 5 5
5 5 1 10 99 99 99 99 10 1 5 99 99 99 5 5 99 99 99 5 1 5 99 99 1 99 5 99 99 5 1 5 99 1 99 10 99 99 5 1 5 5
5 5 1 10 99 99 99 99 10 1 5 99 99 99 5 5 99 99 1 1 1 5 99 99 99 99 5 99 99 5 1 5 99 99 99 10 99 99 5 1 5 5
5 5 1 10 99 99 99 10 10 1 1 1 99 99 5 5 99 99 99 5 1 5 5 5 5 5 5 99 1 1 1 5 5 5 5 10 99 1 1 1 5 5
5 5 1 10 99 99 99 10 10 1 1 1 99 99 5 5 99 99 99 5 1 5 5 5 5 5 5 99 1 1 1 5 5 5 5 10 99 1 1 1 5 5
5 5 5 5 5 5 5 5 5 5 5 5 5 5 5 5 5 5 5 5 5 5 5 5 5 5 5 5 5 5 5 5 5 5 5 5 5 5 5 5 5 5
5 5 5 5 5 5 5 5 5 5 5 5 5 5 5 5 5 5 5 5 5 5 5 5 5 5 5 5 5 5 5 5 5 5 5 5 5 5 5 5 5 5
5 5 5 5 5 5 5 5 5 5 5 5 5 5 5 5 5 5 5 5 5 5 5 5 5 5 5 5 5 5 5 5 5 5 5 5 5 5 5 5 5 5
5 5 5 5 5 5 5 5 5 5 5 5 5 5 5 5 5 5 5 5 5 5 5 5 5 5 5 5 5 5 5 5 5 5 5 5 5 5 5 5 5 5
5 5 5 5 5 5 5 5 5 5 5 5 5 5 5 5 5 5 5 5 5 5 5 5 5 5 5 5 5 5 5 5 5 5 5 5 5 5 5 5 5 5
5 5 5 5 5 5 5 5 5 5 5 5 5 5 5 5 5 5 5 5 5 5 5 5 5 5 5 5 5 5 5 5 5 5 5 5 5 5 5 5 5 5
5 5 5 5 5 5 5 5 5 5 5 5 5 5 5 5 5 5 5 5 5 5 5 5 5 5 5 5 5 5 5 5 5 5 5 5 5 5 5 5 5 5
5 5 5 5 5 5 5 5 5 5 5 5 5 5 5 5 5 5 5 5 5 5 5 5 5 5 5 5 5 5 5 5 5 5 5 5 5 5 5 5 5 5
5 5 5 5 5 5 5 5 5 5 5 5 5 5 5 5 5 5 5 5 5 5 5 5 5 5 5 5 5 5 5 5 5 5 5 5 5 5 5 5 5 5
5 5 5 5 5 5 5 5 5 5 5 5 5 5 5 5 5 5 5 5 5 5 5 5 5 5 5 5 5 5 5 5 5 5 5 5 5 5 5 5 5 5
5 5 5 5 5 5 5 5 5 5 5 5 5 5 5 5 5 5 5 5 5 5 5 5 5 5 5 5 5 5 5 5 5 5 5 5 5 5 5 5 5 5
5 5 5 5 5 5 5 5 5 5 5 5 5 5 5 5 5 5 5 5 5 5 5 5 5 5 5 5 5 5 5 5 5 5 5 5 5 5 5 5 5 5
5 5 5 5 5 5 5 5 5 5 5 5 5 5 5 5 5 5 5 5 5 5 5 5 5 5 5 5 5 5 5 5 5 5 5 5 5 5 5 5 5 5
5 5 5 5 5 5 5 5 5 5 5 5 5 5 5 5 5 5 5 5 5 5 5 5 5 5 5 5 5 5 5 5 5 5 5 5 5 5 5 5 5 5
5 5 5 5 5 5 5 5 5 5 5 5 5 5 5 5 5 5 5 5 5 5 5 5 5 5 5 5 5 5 5 5 5 5 5 5 5 5 5 5 5 5
5 5 5 5 5 5 5 5 5 5 5 5 5 5 5 5 5 5 5 5 5 5 5 5 5 5 5 5 5 5 5 5 5 5 5 5 5 5 5 5 5 5
5 5 5 5 5 5 5 5 5 5 5 5 5 5 5 5 5 5 5 5 5 5 5 5 5 5 5 5 5 5 5 5 5 5 5 5 5 5 5 5 5 5

